XXXXXX
X@   X
X    X
X    X
X  G X
X    X
XXXXXX
