XXXXXX
XG   X
X    X
X    X
X  @ X
X    X
XXXXXX
